000000000000000000000000000000000000000000000002000000000000000000000000000000000000000000000000
000000000000000000000000000222222000000000000001220000000000000000000000000002000000000000000000
222200002222000000000000002111100000000000000001100000000000000000000000022221200000000000000000
11112002111102222000222222111100000000000000022100000000000000000000000000001112000000000000000011111111111111111111111111111111111111111111
11111111111121111222111111111122222222200000001100000000000000000000000000000110000000000000222211111111111111111111111111111111111111111111          
111111111111111111111111111111111111111200020001000000000000000000000000000001122000000022221111111113311111111111111111111111111111111111111
11111111111111111111111111111111111111112221200120000000000000000000000000000011120000021111111111111111111111111111111111111111111111111111
111111111111111111111111111111111111111111111221122200022222222222222222222222111122222111111131111131111113111111111333111111113111111111111111111111111111111111111111111111111111
11111111111111111111111111111111111111113111111113110001111111111131111111311111111111111111111111111111111331111111113111113333111113111111111111111111111111111111111111111111111
11111111111111111111111111111111111111111111113111110001131111113111111113311111111111111111113111111111111111111111111111113111111111111111111111111111111111111111111111111111111
11111111111111111111111111111111111111113331130000000000000000000000000333333333333333333333333333333333333333333333311113111111111311111111331111111111111111111111111111111111111
11111111111111111111111111113311111111111131130003333333333333333333000000000000000000000000000000000000000000000000311111111113333311111111111111111111111111111111
111111111111111111111111111111111131111111111300031311111311111131130000000000000000003333333333333333333330003333333111131111130003113331111111111111111111111111111111111111111111
11111111111111111111111111111111111111133333330003333333333333331113333333333333333000331111111113113333333000333333333111111113000311113111111111111111111111111111111111111111111
11111111111111111111133111111111111131130000000000000330000000031111311113000000000000311111311111113000000000000000003311133113000311111111111111111111111111111111111111111111111
11111111111111111111111111111331131111130003333333000333333300033333333333000333333333311111111133113000333333333330003113111113000311111111111111111111111111111111111111111111111
11111111111111111111311111333333333333330003111113000333333300000000000000000333333333333333333333333000311311111130003333333113000311311111111111111111111111111111111111111111111
111111111111111111111111133000000000000000031113130000000033333333333333330000000000000000000000000000003111111311300000000031130003311111133111111111111111111111111111111111111111
11111111111111111111111111300033333333333333111113333330003111111111111113333333333333300033333333333333311113311133333330003113000311111111111111111111111111111111111111111111111
11111111111111133111111311300000000000311111331133333330003333333333333333333333333333300033333333333333311113111111111130003333000333333311111111111111111111111111111111111111111
11111111111111113111111111333333333000311311111130000000000000000000000300000000000000000000000000000000311111111113111130000000000000000311111111111111111111111111111111111111111
111111111111111111113111111131131130003333333333300033333333333333330003000333333333333333333333333330003113111111133111333333333333330003111111331111111111111111111111111111111111
11111111111111111111111111111113333333330000000000003111133333333333000300033333331113111111111333333000333333333333333333333311311113000311111111111111111111111111111111111111111
11111111111111111111111111331111300000000003333333333131130000000000000300000000031111111133111300000000000000000000000000000311113113000333111111113111111111111111111111111111111
11111111111111111111111111111111300033333333111111111311130003333333333333333300033333333333333300033333333333333330003333000311131113333311111111111111111111111111111111111111111
11111111111111111111111111111111300033333333333333333333330003111111311111111300000000000000000000031311111331111130003333000311111111113111311111111111111111111111111111111111111
11111111111111111111111111111111300000000000000000000000030003331131111331111333333333300033333300031111111111131130000000000333111113111111111311111111111111111111111111111111111
11111111111111111111111111111113333333300033333333333333330003111113333333333333333333300031111300031113111111111130003333333311111133111311133311111111111111111111111111111111111
11111111111111111111111111111111111111300033333333333333330003311113000000000000000000000031131300033333333333333330003113333333333333333333333331111111111111111111111111111111111
11111111111111111111111111111133111113300000000000000000000003111113000333333333333333333331111300000000000000000000003113000000000000000000000031111333111111111111111111111111111
11111111111111111111113111111111111311333333333333333333333333333333000333333333333333333333333333333333333333333333333333000333333333333333300031111111111111111111111111111111111
11111111111111111111133111111113111111113311130000000000000000000000000000000000000000000000000000000000000000000000000000000311111111111111300031111111111111111111111111111111111
111111111111111111111111111311111131111111131300033333333333333333333333333333333333333333333333000333333333333333300033333333111111331111111300031311111111111111111111111111111111
11111111111111111111111111133333333333333333330003131131333333333333333333333131111331111311111300033333333333333330003111111111111111111111333331111111111111111111111111111111111
11111111111111111111111131130000000000000000000003111311300000000000000000003111111311111111113300000000000000000000003311111113111111111311111111111111111111111111111111111111111
11111111111111111111111111133333333333333333333333311111333333333333333330003331111111311111311333300033333333333333333111111111111111111111111111111111111111111111111111111111111
11111111111111111111111311111131113311113111111113111111131111111133333330003333333333333333333333300031111111111111111113311111111111111111111111111111111111111111111111111111111
11111111111111111111111111111111113111113111131111111131111113111130000000000000000000000000000000000033111111311111111111111111111111111111111111111111111111111111111111111111111
111111111111111111311111133111311111111111113111111111131111111113300033333333333333333333333333333333331111111111111111111111111111111111111111111111111111111111111111111111111111
11111111111111111111111111131111113333333333333333333333333333333330003333333333333333331111111111111113111111111111111111111111111111111111111111111111111111111111111111111111111
1111111111111111111111111111111111300000000000000000000000000000000000000000000000000003111111111111111111111111111111111111111111111111111111111111111111111111111111111111111
11111111111111111111111131111111333000000000000000333333333333333333333333333333333300033333333333311111331111111111111111111111111111111111111111111111111111111111111111111111111
1111111111111111111111111111111111300000004000000031133111311111111111111113111111130000000000000031111113111111111111111111111111111111111111111111111111111111111111111111111
111111111111111111111111113311111333333333333333333311311111111111113111331111111113333333333333333311131113111111111111111111111111111111111111111111111111111111111111111111
1111111111111111111111111131111111133350000000000333331111111113111111111111111111131111311111113311111111111111111111111111111111111111111111111111111111111111111111111111111
111111111111111111111111111113111113330000000000033311111111111111111111111111113311111111311111111113311111111111111111111111111111111111111111111111111111111111111111111111
111111111111111111111111111111111111133333333333311111111111111111111111111111111111111111111131111111111111111111111111111111111111111111111111111111111111111111111111111111
111111111111111111111111111111111111111113111333111111111111111331111111111111111111113111111111111111111111111111111111111111111111111111111111111111111111111111111111111111
111111111111111111111111111113111111113111111111111111111111111111111111111111111111111111111111111111111111111111111111111111111111111111111111111111111111111111111111111111
111111111111111111111111111111111111111111111111111111111111111111111111111111111111111111111111111111111111111111111111111111111111111111111111111111111111111111111111111111